111111111111111
110000VC10011E1
10000000C000001
1C000P0110C0V01
1C0000000000001
1C00V00000C0001
111111111111111